R 100000000000 100000000000
NO ./textures/black_wall.xpm
SO ./textures/grey_wall.xpm
WE ./textures/red_wall.xpm
EA ./textures/window_wall.xpm
S ./textures/barrel.xpm
F 36,36,36
C 0,0,0

111111111111111111111111111111111
100000000011000001110111111111111
11110111111111011100000010001
11110111111111011101010010001
11000000110101011100000010001
10002000000000001100000010001
10000000000000001101010010001
10002000000000001100000010001
10000000000000001101010010001
10002000000N00001100000010001
10000000000000001101010010001
10002000000000001100000010001
10000000000000001101010010001
110000011101010111110111100111
11110111 1110101 101111010001
11111111 1111111 111111111111